#                       #
#                       #
#                       #
# P                  ab##
#####cd            ab####
     ###cd         ######
        ###cd           #
           ###cd        #
              ###########
