#                       #
#                       #
#                       #
# PM                 ab##
#####cdKKK         ab####
     ###cd         ######
        ###cd           #
           ###cd   D  K #
              ###########
