#                       #
#                       #
#                       #
# PM                 ab##
#####cd            ab####
     ###cd         ######
        ###cd           #
           ###cd   D  K #
              ###########
