#                       #
#                       #
#                       #
# a                     #
######                  #
     ####               #
        ####            #
           ####         #
              ###########
