actions: J
-----
#                  #
#                  #
#                  #
#                 A#
#             G ab##
#             ab####
#P M          ######
#####cd            #
    ###cd  #  D    #
     ###############
      #### # ####
-----
