actions: J
girl: Hello.
-----
#                       #
#                       #
#                       #
# P                   G #
###  ab# K           ####
# #########  ###cd      #
# ####  ##     # #cd    #
#    #####     # # #cd N#
#cd L   A      # #   ####
################ #     ##
#    ##    ##    #     ##
----
