-----
              M          
             ####cd      
       abcd       ####   
  D  ab########cd        
########      ####cd     
            G #  ####cd  
            #############
  P     D            N   
#########################
-----
