
                  M
   M  K         ab##
########      ######

                   G 
     ab#########  ##
   ab####         #   
 L ##   # P D     ##
#####   ############
