----


P
####cd
 #  ##cd         ####
 #    ##cd       #  #
 #             ab#  #cd
 #           ab#      ##
 #         ab#             ##
 #    ######               #
 ######                 ab##
   #                  ab#
   #                ab#
   #  ###############
   #
   #
   #
   #
   #cd
     #cd         ######
       #cd       #    #cd
         ####cd  #      #cd A
              ####      #####
----
